############
#        O #
#   P   ####
#          #
#######    #
# O ##     #
#   ##     #
#          #
#    XX    #
# #        #
############
